LIAISON_INF__LIAISON;CHAUSSEE_INF__SENS;ABS_DEB;ABS_FIN;CD_TPC_INF__CODE;LARGEUR
3;3;8238;8259;ITPC;21
3;3;9125;9185;ITPC;60
3;3;11263;11333;ITPC;70
3;3;12999;13037;ITPC;38
3;3;13037;13076;ITPC;39
3;3;13345;13371;ITPC;26
3;3;18415;18469;ITPC;54
3;3;20591;20671;ITPC;80
3;3;20977;21009;ITPC;32
3;3;22304;22370;ITPC;66
3;3;24526;24596;ITPC;70
3;3;26691;26751;ITPC;60
3;3;29128;29210;ITPC;82
3;3;31412;31483;ITPC;71
3;3;32559;32589;ITPC;30
3;3;33002;33028;ITPC;26
3;3;33681;33741;ITPC;60
3;3;35010;35060;ITPC;50
3;3;36959;37038;ITPC;79
3;3;38715;38795;ITPC;80
3;3;40671;40751;ITPC;80
3;3;43748;43818;ITPC;70
3;3;45793;45873;ITPC;80
3;3;47171;47241;ITPC;70
3;3;49589;49659;ITPC;70
3;3;51406;51486;ITPC;80
3;3;52454;52483;ITPC;29
3;3;53170;53258;ITPC;88
3;3;55062;55142;ITPC;80
3;3;57087;57167;ITPC;80
3;3;59054;59094;ITPC;40
3;3;59094;59135;ITPC;41
3;3;60902;60973;ITPC;71
3;3;62682;62752;ITPC;70
3;3;64678;64757;ITPC;79
3;3;65285;65357;ITPC;72
3;3;66695;66767;ITPC;72
3;3;68515;68573;ITPC;58
3;3;68573;68627;ITPC;54
3;3;70236;70323;ITPC;87
3;3;73059;73128;ITPC;69
3;3;74220;74293;ITPC;73
3;3;76093;76173;ITPC;80
3;3;78822;78882;ITPC;60
3;3;80609;80688;ITPC;79
3;3;82981;83053;ITPC;72
3;3;84381;84457;ITPC;76
3;3;86542;86611;ITPC;69
3;3;88038;88107;ITPC;69
3;3;90129;90201;ITPC;72
3;3;91535;91625;ITPC;90
3;3;93475;93564;ITPC;89
3;3;95612;95685;ITPC;73
3;3;97517;97577;ITPC;60
3;3;99686;99764;ITPC;78
3;3;101313;101370;ITPC;57
3;3;102523;102594;ITPC;71
3;3;104632;104701;ITPC;69
3;3;107061;107126;ITPC;65
3;3;109728;109794;ITPC;66
3;3;112051;112121;ITPC;70
3;3;114080;114092;ITPC;12
3;3;114557;114626;ITPC;69
3;3;116584;116649;ITPC;65
3;3;119168;119239;ITPC;71
3;3;121444;121519;ITPC;75
3;3;123487;123548;ITPC;61
3;3;126503;126588;ITPC;85
3;3;128483;128566;ITPC;83
3;3;130631;130699;ITPC;68
3;3;132696;132771;ITPC;75
3;3;135348;135442;ITPC;94
3;3;135536;135626;ITPC;90
3;3;137447;137542;ITPC;95
3;3;139357;139440;ITPC;83
3;3;141066;141095;ITPC;29
3;3;141095;141154;ITPC;59
3;3;143045;143135;ITPC;90
3;3;145090;145175;ITPC;85
3;3;146891;146974;ITPC;83
3;3;148200;148284;ITPC;84
3;3;152233;152326;ITPC;93
3;3;153216;153302;ITPC;86
3;3;155840;155923;ITPC;83
3;3;157295;157324;ITPC;29
3;3;157324;157393;ITPC;69
3;3;157811;157838;ITPC;27
3;3;157838;157901;ITPC;63
3;3;158798;158904;ITPC;99
3;3;159290;159380;ITPC;90
3;3;160078;160121;ITPC;43
3;3;160121;160164;ITPC;43
3;3;161386;161472;ITPC;86
3;3;163476;163562;ITPC;86
3;3;165399;165484;ITPC;85
3;3;167444;167529;ITPC;85
3;3;169914;170000;ITPC;86
3;3;171923;172007;ITPC;84
3;3;173815;173881;ITPC;66
3;3;175803;175869;ITPC;66
3;3;177888;177952;ITPC;64
3;3;179783;179816;ITPC;33
3;3;179816;179868;ITPC;52
3;3;181989;182074;ITPC;85
3;3;183995;184062;ITPC;67
3;3;185605;185705;ITPC;99
3;3;187787;187870;ITPC;83
3;3;189795;189889;ITPC;94
3;3;191805;191875;ITPC;70
3;3;193810;193874;ITPC;64
3;3;195867;195917;ITPC;50
3;3;197745;197826;ITPC;81
3;3;199819;199905;ITPC;86
3;3;201480;201513;ITPC;33
3;3;201513;201569;ITPC;56
3;3;203937;204023;ITPC;86
3;3;206311;206398;ITPC;87
3;3;208122;208212;ITPC;90
3;3;209782;209819;ITPC;37
3;3;209819;209870;ITPC;51
3;3;212350;212443;ITPC;93
3;3;214665;214753;ITPC;88
3;3;215192;215242;ITPC;50
3;3;215242;215281;ITPC;39
3;3;216954;217041;ITPC;87
3;3;219328;219422;ITPC;94
3;3;221846;221939;ITPC;93
3;3;224465;224537;ITPC;72
3;3;225258;225324;ITPC;66
3;3;225884;225964;ITPC;80
3;3;227173;227241;ITPC;68
3;3;227940;228004;ITPC;64
3;3;228954;229015;ITPC;61
3;3;232578;232671;ITPC;93
3;3;234805;234875;ITPC;70
3;3;237085;237175;ITPC;90
3;3;239485;239575;ITPC;90
3;3;241990;242081;ITPC;91
3;3;244481;244499;ITPC;18
3;3;244499;244569;ITPC;70
3;3;246879;246966;ITPC;87
3;3;249239;249328;ITPC;89
3;3;251236;251325;ITPC;89
3;3;253142;253231;ITPC;89
3;3;255143;255233;ITPC;90
3;3;257443;257509;ITPC;66
3;3;257509;257532;ITPC;23
3;3;259442;259532;ITPC;90
3;3;261435;261524;ITPC;89
3;3;263436;263524;ITPC;88
3;3;264236;264323;ITPC;87
3;3;265932;266020;ITPC;88
3;3;267028;267118;ITPC;90
3;3;269826;269915;ITPC;89
3;3;272222;272311;ITPC;89
3;3;274521;274609;ITPC;88
3;3;276718;276808;ITPC;90
3;3;279414;279459;ITPC;45
3;3;279459;279503;ITPC;44
3;3;281413;281503;ITPC;90
3;3;282418;282508;ITPC;90
3;3;284489;284552;ITPC;63
3;3;286488;286553;ITPC;65
3;3;288491;288556;ITPC;65
3;3;291157;291222;ITPC;65
3;3;292298;292323;ITPC;25
3;3;292323;292364;ITPC;41
3;3;294283;294349;ITPC;66
3;3;296486;296552;ITPC;66
3;3;298488;298553;ITPC;65
3;3;300586;300651;ITPC;65
3;3;302588;302651;ITPC;63
3;3;304591;304655;ITPC;64
3;3;306592;306660;ITPC;68
3;3;308393;308459;ITPC;66
3;3;310088;310154;ITPC;66
3;3;312351;312416;ITPC;65
3;3;314493;314559;ITPC;66
3;3;316494;316560;ITPC;66
3;3;318805;318845;ITPC;40
3;3;321004;321092;ITPC;88
3;3;322982;323056;ITPC;74
3;3;323056;323070;ITPC;14
3;3;323925;323969;ITPC;44
3;3;324124;324169;ITPC;45
3;3;324344;324374;ITPC;30
3;3;324374;324397;ITPC;23
3;3;324789;324799;ITPC;10
3;3;324799;324897;ITPC;98
3;3;325663;325759;ITPC;96
3;3;327012;327101;ITPC;89
3;3;329988;330077;ITPC;89
3;3;329990;330014;ITPC;24
3;3;330014;330076;ITPC;62
3;3;331687;331775;ITPC;88
3;3;336505;336554;ITPC;49
3;3;336554;336594;ITPC;40
3;3;338514;338595;ITPC;81
3;3;340577;340666;ITPC;89
3;3;342522;342557;ITPC;35
3;3;342557;342611;ITPC;54
3;3;344422;344511;ITPC;89
3;3;346729;346770;ITPC;41
3;3;346770;346819;ITPC;49
3;3;348935;348983;ITPC;48
3;3;348983;349023;ITPC;40
3;3;349490;349579;ITPC;89
3;3;353466;353481;ITPC;15
3;3;355437;355528;ITPC;91
3;3;357625;357714;ITPC;89
3;3;359091;359131;ITPC;40
3;3;359131;359179;ITPC;48
3;3;361776;361866;ITPC;90
3;3;363613;363704;ITPC;91
3;3;365717;365761;ITPC;44
3;3;365761;365807;ITPC;46
3;3;367078;367126;ITPC;48
3;3;367126;367171;ITPC;45
3;3;369090;369179;ITPC;89
3;3;370389;370441;ITPC;52
3;3;370441;370460;ITPC;19
3;3;370460;370478;ITPC;18
3;3;373886;373976;ITPC;90
3;3;375891;375961;ITPC;70
3;3;375961;375981;ITPC;20
3;3;377694;377710;ITPC;16
3;3;377710;377782;ITPC;72
3;3;378850;378942;ITPC;92
3;3;379796;379885;ITPC;89
3;3;381596;381667;ITPC;71
3;3;381667;381686;ITPC;19
3;3;383599;383687;ITPC;88
3;3;385600;385688;ITPC;88
3;3;387606;387647;ITPC;41
3;3;387647;387695;ITPC;48
3;3;389604;389645;ITPC;41
3;3;389645;389692;ITPC;47
3;3;391827;391897;ITPC;70
5;3;43363;43424;ITPC;61
5;3;41472;41535;ITPC;63
5;3;39570;39634;ITPC;64
5;3;36934;36998;ITPC;64
5;3;35482;35545;ITPC;63
5;3;33485;33549;ITPC;64
5;3;31482;31547;ITPC;65
5;3;29686;29749;ITPC;63
5;3;27319;27332;ITPC;13
5;3;22871;22937;ITPC;66
5;3;21195;21218;ITPC;23
5;3;21185;21195;ITPC;10
5;3;21165;21185;ITPC;20
5;3;21153;21165;ITPC;12
5;3;19116;19175;ITPC;59
5;3;14394;14430;ITPC;36
5;3;14368;14394;ITPC;26
5;3;13281;13310;ITPC;29
5;3;13244;13281;ITPC;37
5;3;11895;11933;ITPC;38
5;3;11871;11895;ITPC;24
5;3;9772;9842;ITPC;70
5;3;8373;8433;ITPC;60
5;3;6370;6439;ITPC;69
5;3;3970;4031;ITPC;61
5;3;2175;2246;ITPC;71
7;3;28040;28053;ITPC;13
7;3;28009;28040;ITPC;31
7;3;27441;27499;ITPC;58
7;3;24977;25013;ITPC;36
7;3;24950;24977;ITPC;27
7;3;24913;24950;ITPC;37
7;3;22669;22747;ITPC;78
7;3;20759;20849;ITPC;90
7;3;18302;18358;ITPC;56
7;3;15413;15472;ITPC;59
7;3;12180;12245;ITPC;65
7;3;9896;9968;ITPC;72
7;3;8110;8177;ITPC;67
7;3;5401;5471;ITPC;70
7;3;3514;3574;ITPC;60
7;3;1476;1542;ITPC;66
201;3;2313;2336;ITPC;23
301;3;1830;1884;ITPC;54
301;3;3646;3712;ITPC;66
301;3;5704;5778;ITPC;74
301;3;7623;7689;ITPC;66
301;3;9600;9665;ITPC;65
301;3;11606;11674;ITPC;68
5;3;264665;264710;ITPC;45
5;3;264198;264248;ITPC;50
5;3;260950;260996;ITPC;46
5;3;258884;258928;ITPC;44
5;3;256402;256448;ITPC;46
5;3;249706;249742;ITPC;36
5;3;247300;247350;ITPC;50
5;3;244815;244884;ITPC;69
5;3;242611;242675;ITPC;64
5;3;241303;241359;ITPC;56
5;3;239474;239552;ITPC;78
5;3;236681;236717;ITPC;36
5;3;235893;235943;ITPC;50
5;3;234084;234128;ITPC;44
5;3;231761;231801;ITPC;40
5;3;229117;229167;ITPC;50
5;3;226377;226420;ITPC;43
5;3;225249;225296;ITPC;47
5;3;224530;224567;ITPC;37
5;3;220024;220066;ITPC;42
5;3;219340;219378;ITPC;38
5;3;216860;216905;ITPC;45
5;3;214843;214886;ITPC;43
5;3;213295;213338;ITPC;43
5;3;212159;212213;ITPC;54
5;3;209120;209166;ITPC;46
5;3;207593;207645;ITPC;52
5;3;205512;205559;ITPC;47
5;3;203505;203552;ITPC;47
5;3;201114;201160;ITPC;46
5;3;199498;199552;ITPC;54
5;3;197037;197092;ITPC;55
5;3;195721;195753;ITPC;32
5;3;193745;193783;ITPC;38
5;3;191082;191138;ITPC;56
5;3;189267;189325;ITPC;58
5;3;187187;187242;ITPC;55
5;3;185314;185370;ITPC;56
5;3;183623;183680;ITPC;57
5;3;181630;181668;ITPC;38
5;3;179068;179103;ITPC;35
5;3;177503;177539;ITPC;36
5;3;175642;175676;ITPC;34
5;3;173691;173727;ITPC;36
5;3;171056;171092;ITPC;36
5;3;168354;168388;ITPC;34
5;3;166866;166901;ITPC;35
5;3;165471;165507;ITPC;36
5;3;163361;163392;ITPC;31
5;3;160321;160367;ITPC;46
5;3;157780;157820;ITPC;40
5;3;155787;155828;ITPC;41
5;3;152315;152349;ITPC;34
5;3;151689;151712;ITPC;23
5;3;150443;150481;ITPC;38
5;3;147688;147727;ITPC;39
5;3;145707;145745;ITPC;38
5;3;144680;144718;ITPC;38
5;3;142495;142535;ITPC;40
5;3;141084;141122;ITPC;38
5;3;138850;138880;ITPC;30
5;3;137128;137161;ITPC;33
5;3;134917;134953;ITPC;36
5;3;133083;133113;ITPC;30
5;3;130639;130671;ITPC;32
5;3;128320;128359;ITPC;39
5;3;126441;126480;ITPC;39
5;3;124431;124471;ITPC;40
5;3;122291;122331;ITPC;40
5;3;120521;120561;ITPC;40
5;3;119375;119411;ITPC;36
5;3;118902;118951;ITPC;49
5;3;118282;118362;ITPC;80
5;3;117616;117664;ITPC;48
5;3;115531;115570;ITPC;39
5;3;113624;113646;ITPC;22
5;3;109574;109605;ITPC;31
5;3;107663;107708;ITPC;45
5;3;105724;105760;ITPC;36
5;3;103607;103637;ITPC;30
5;3;101544;101573;ITPC;29
5;3;99265;99300;ITPC;35
5;3;97026;97054;ITPC;28
5;3;95105;95135;ITPC;30
5;3;93237;93258;ITPC;21
5;3;91586;91616;ITPC;30
5;3;89105;89194;ITPC;89
5;3;85743;85815;ITPC;72
5;3;82734;82814;ITPC;80
5;3;80429;80519;ITPC;90
5;3;77851;77867;ITPC;16
5;3;77217;77287;ITPC;70
1;3;61855;61925;ITPC;70
1;3;64071;64147;ITPC;76
1;3;66493;66567;ITPC;74
1;3;68867;68942;ITPC;75
1;3;71089;71151;ITPC;62
1;3;72828;72894;ITPC;66
1;3;75624;75686;ITPC;62
1;3;77190;77258;ITPC;68
1;3;77412;77433;ITPC;21
1;3;77585;77650;ITPC;65
1;3;79884;79949;ITPC;65
1;3;80210;80273;ITPC;63
1;3;82292;82354;ITPC;62
1;3;83879;83952;ITPC;73
1;3;86640;86702;ITPC;62
1;3;86702;86711;ITPC;9
1;3;86766;86799;ITPC;33
1;3;86799;86838;ITPC;39
1;3;88207;88274;ITPC;67
1;3;91098;91178;ITPC;80
1;3;94321;94402;ITPC;81
1;3;96256;96342;ITPC;86
1;3;97843;97932;ITPC;89
1;3;99629;99699;ITPC;70
1;3;102052;102138;ITPC;86
1;3;104031;104104;ITPC;73
1;3;107076;107145;ITPC;69
1;3;109392;109424;ITPC;32
1;3;109424;109472;ITPC;48
1;3;111662;111744;ITPC;82
1;3;113517;113597;ITPC;80
1;3;115400;115476;ITPC;76
1;3;117447;117528;ITPC;81
1;3;119482;119568;ITPC;86
1;3;121350;121419;ITPC;69
1;3;123204;123319;ITPC;99
1;3;125264;125335;ITPC;71
1;3;125335;125356;ITPC;21
1;3;127450;127554;ITPC;99
1;3;129002;129104;ITPC;99
1;3;131205;131305;ITPC;99
1;3;133066;133165;ITPC;99
1;3;135420;135463;ITPC;43
1;3;135463;135504;ITPC;41
1;3;136909;136919;ITPC;10
1;3;136919;136983;ITPC;64
1;3;138336;138362;ITPC;26
1;3;138362;138405;ITPC;43
1;3;140413;140441;ITPC;28
1;3;140440;140481;ITPC;41
1;3;142450;142540;ITPC;90
1;3;144935;145017;ITPC;82
1;3;147100;147170;ITPC;70
1;3;149254;149326;ITPC;72
1;3;151280;151376;ITPC;96
1;3;153338;153405;ITPC;67
1;3;155569;155597;ITPC;28
1;3;155597;155644;ITPC;47
1;3;158149;158192;ITPC;43
1;3;158192;158224;ITPC;32
1;3;160449;160522;ITPC;73
1;3;162051;162129;ITPC;78
1;3;163102;163145;ITPC;43
1;3;163145;163166;ITPC;21
1;3;165553;165615;ITPC;62
1;3;167532;167588;ITPC;56
3;3;391897;391916;ITPC;19
3;3;393110;393128;ITPC;18
3;3;393128;393201;ITPC;73
3;3;395307;395360;ITPC;53
3;3;395360;395398;ITPC;38
3;3;399009;399058;ITPC;49
3;3;399058;399090;ITPC;32
3;3;399090;399100;ITPC;10
3;3;400911;400925;ITPC;14
3;3;400925;401001;ITPC;76
3;3;402816;402870;ITPC;54
3;3;402870;402919;ITPC;49
3;3;404419;404508;ITPC;89
3;3;406523;406560;ITPC;37
3;3;406560;406613;ITPC;53
3;3;408534;408607;ITPC;73
3;3;408607;408623;ITPC;16
3;3;410639;410728;ITPC;89
3;3;412443;412505;ITPC;62
3;3;412505;412534;ITPC;29
3;3;414449;414535;ITPC;86
3;3;416445;416536;ITPC;91
3;3;419971;420037;ITPC;66
3;3;421054;421119;ITPC;65
3;3;422613;422677;ITPC;64
3;3;425573;425641;ITPC;68
3;3;427821;427887;ITPC;66
3;3;429523;429598;ITPC;75
3;3;429598;429616;ITPC;18
5;3;45605;45665;ITPC;60
5;3;45598;45605;ITPC;7
2;3;18186;18206;ITPC;20
2;3;21044;21072;ITPC;28
2;3;23281;23303;ITPC;22
2;3;25158;25188;ITPC;30
2;3;27455;27474;ITPC;19
2;3;29548;29570;ITPC;22
2;3;31939;31958;ITPC;19
2;3;33091;33112;ITPC;21
2;3;35218;35240;ITPC;22
2;3;37079;37100;ITPC;21
2;3;39404;39424;ITPC;20
2;3;41056;41077;ITPC;21
2;3;43466;43486;ITPC;20
2;3;45241;45261;ITPC;20
2;3;47389;47410;ITPC;21
2;3;49518;49538;ITPC;20
2;3;50662;50682;ITPC;20
2;3;53749;53769;ITPC;20
2;3;55195;55222;ITPC;27
2;3;56245;56265;ITPC;20
2;3;58084;58106;ITPC;22
2;3;60594;60616;ITPC;22
2;3;62524;62545;ITPC;21
2;3;63390;63411;ITPC;21
2;3;65935;65963;ITPC;28
2;3;67596;67618;ITPC;22
2;3;68344;68354;ITPC;10
2;3;69379;69409;ITPC;30
2;3;71406;71435;ITPC;29
2;3;73324;73354;ITPC;30
2;3;83650;83671;ITPC;21
2;3;85451;85481;ITPC;30
2;3;88218;88260;ITPC;42
2;3;90150;90190;ITPC;40
2;3;92371;92404;ITPC;33
2;3;94533;94550;ITPC;17
2;3;96319;96348;ITPC;29
2;3;98667;98694;ITPC;27
2;3;100983;101011;ITPC;28
2;3;102749;102778;ITPC;29
2;3;104075;104115;ITPC;40
2;3;104644;104676;ITPC;32
2;3;107086;107112;ITPC;26
2;3;109183;109212;ITPC;29
2;3;111324;111354;ITPC;30
2;3;113811;113840;ITPC;29
2;3;116670;116700;ITPC;30
2;3;119862;119911;ITPC;49
2;3;121094;121120;ITPC;26
2;3;123547;123596;ITPC;49
2;3;124805;124835;ITPC;30
2;3;128288;128367;ITPC;79
2;3;129885;129919;ITPC;34
2;3;132371;132416;ITPC;45
2;3;136402;136461;ITPC;59
2;3;138681;138696;ITPC;15
2;3;140998;141045;ITPC;47
2;3;144050;144070;ITPC;20
2;3;145917;146012;ITPC;95
2;3;147313;147356;ITPC;43
2;3;149246;149299;ITPC;53
2;3;150758;150780;ITPC;22
2;3;195565;195588;ITPC;23
2;3;195588;195655;ITPC;67
2;3;198558;198600;ITPC;42
2;3;198600;198647;ITPC;47
2;3;201576;201592;ITPC;16
2;3;201592;201656;ITPC;64
2;3;203986;204018;ITPC;32
2;3;204018;204076;ITPC;58
2;3;206974;207062;ITPC;88
2;3;212797;212877;ITPC;80
2;3;215799;215880;ITPC;81
2;3;218588;218676;ITPC;88
2;3;221508;221599;ITPC;91
2;3;225184;225267;ITPC;83
2;3;227484;227573;ITPC;89
2;3;230245;230329;ITPC;84
2;3;233268;233327;ITPC;59
2;3;236253;236333;ITPC;80
2;3;239245;239336;ITPC;91
2;3;242083;242171;ITPC;88
2;3;243058;243139;ITPC;81
2;3;245259;245337;ITPC;78
2;3;247356;247436;ITPC;80
2;3;249733;249810;ITPC;77
2;3;250175;250226;ITPC;51
2;3;250226;250256;ITPC;30
2;3;252951;253031;ITPC;80
2;3;255845;255910;ITPC;65
2;3;256246;256311;ITPC;65
2;3;258547;258611;ITPC;64
2;3;258889;258953;ITPC;64
2;3;260151;260216;ITPC;65
2;3;260656;260718;ITPC;62
2;3;261053;261117;ITPC;64
2;3;261555;261619;ITPC;64
2;3;263993;264081;ITPC;88
2;3;265388;265485;ITPC;97
2;3;266999;267051;ITPC;52
2;3;267051;267085;ITPC;34
2;3;268372;268468;ITPC;96
2;3;271181;271193;ITPC;12
2;3;271193;271241;ITPC;48
2;3;271241;271276;ITPC;35
2;3;272412;272436;ITPC;24
2;3;272436;272459;ITPC;23
2;3;272459;272485;ITPC;26
2;3;272485;272507;ITPC;22
2;3;273777;273801;ITPC;24
2;3;273801;273827;ITPC;26
2;3;273827;273850;ITPC;23
2;3;273850;273874;ITPC;24
2;3;275669;275766;ITPC;97
2;3;277506;277533;ITPC;27
2;3;277533;277559;ITPC;26
2;3;277559;277583;ITPC;24
2;3;277583;277602;ITPC;19
2;3;279715;279811;ITPC;96
2;3;281367;281462;ITPC;95
2;3;283966;284020;ITPC;54
2;3;284020;284062;ITPC;42
2;3;285326;285350;ITPC;24
2;3;285350;285374;ITPC;24
2;3;285374;285426;ITPC;52
2;3;287264;287361;ITPC;97
2;3;289022;289048;ITPC;26
2;3;289048;289097;ITPC;49
2;3;289097;289118;ITPC;21
2;3;291825;291888;ITPC;63
2;3;291888;291920;ITPC;32
2;3;294164;294213;ITPC;49
2;3;294213;294261;ITPC;48
2;3;295464;295509;ITPC;45
2;3;295509;295519;ITPC;10
2;3;295519;295559;ITPC;40
2;3;296460;296508;ITPC;48
2;3;296508;296556;ITPC;48
2;3;297663;297751;ITPC;88
2;3;299740;299827;ITPC;87
2;3;301657;301746;ITPC;89
2;3;303454;303494;ITPC;40
2;3;303494;303543;ITPC;49
2;3;305451;305499;ITPC;48
2;3;305499;305540;ITPC;41
2;3;307347;307374;ITPC;27
2;3;307374;307398;ITPC;24
2;3;307398;307433;ITPC;35
2;3;309349;309410;ITPC;61
2;3;309410;309437;ITPC;27
2;3;311348;311360;ITPC;12
2;3;311360;311384;ITPC;24
2;3;311384;311410;ITPC;26
2;3;311410;311434;ITPC;24
2;3;313347;313435;ITPC;88
2;3;315348;315437;ITPC;89
2;3;317347;317435;ITPC;88
2;3;319842;319929;ITPC;87
2;3;321538;321621;ITPC;83
2;3;323238;323325;ITPC;87
2;3;325234;325270;ITPC;36
2;3;325270;325321;ITPC;51
2;3;327231;327319;ITPC;88
2;3;329228;329313;ITPC;85
2;3;331226;331315;ITPC;89
2;3;333225;333313;ITPC;88
2;3;335220;335277;ITPC;57
2;3;335277;335309;ITPC;32
2;3;337217;337306;ITPC;89
2;3;339214;339303;ITPC;89
2;3;341211;341299;ITPC;88
2;3;343205;343250;ITPC;45
2;3;343250;343293;ITPC;43
2;3;345098;345191;ITPC;93
2;3;347098;347187;ITPC;89
2;3;349096;349185;ITPC;89
2;3;350994;351083;ITPC;89
2;3;352893;352929;ITPC;36
2;3;352929;352957;ITPC;28
2;3;352957;352979;ITPC;22
2;3;354792;354880;ITPC;88
2;3;356789;356841;ITPC;52
2;3;356841;356878;ITPC;37
2;3;358590;358678;ITPC;88
2;3;360390;360436;ITPC;46
2;3;360436;360478;ITPC;42
2;3;361890;361978;ITPC;88
2;3;367264;367350;ITPC;86
2;3;369122;369208;ITPC;86
2;3;371302;371389;ITPC;87
2;3;373298;373385;ITPC;87
2;3;375358;375446;ITPC;88
2;3;377312;377399;ITPC;87
2;3;379309;379398;ITPC;89
2;3;381309;381366;ITPC;57
2;3;381366;381397;ITPC;31
2;3;384209;384300;ITPC;91
2;3;386083;386171;ITPC;88
2;3;388693;388706;ITPC;13
2;3;388706;388780;ITPC;74
2;3;391598;391685;ITPC;87
2;3;393984;394013;ITPC;29
2;3;394013;394071;ITPC;58
2;3;396603;396690;ITPC;87
2;3;398988;399077;ITPC;89
2;3;401065;401157;ITPC;92
2;3;403056;403148;ITPC;92
2;3;404502;404513;ITPC;11
2;3;404513;404538;ITPC;25
2;3;404538;404564;ITPC;26
2;3;404564;404579;ITPC;15
2;3;404579;404595;ITPC;16
2;3;404953;404974;ITPC;21
2;3;404974;405013;ITPC;39
2;3;405013;405043;ITPC;30
2;3;406864;406877;ITPC;13
2;3;406877;406966;ITPC;89
2;3;408859;408949;ITPC;90
2;3;410512;410564;ITPC;52
2;3;410564;410604;ITPC;40
2;3;411041;411091;ITPC;50
2;3;411091;411133;ITPC;42
2;3;412659;412751;ITPC;92
2;3;414176;414265;ITPC;89
2;3;427776;427869;ITPC;93
2;3;428224;428326;ITPC;99
2;3;430155;430247;ITPC;92
2;3;432157;432244;ITPC;87
2;3;434155;434240;ITPC;85
2;3;435229;435270;ITPC;41
2;3;435270;435315;ITPC;45
2;3;435628;435714;ITPC;86
2;3;437625;437654;ITPC;29
2;3;437654;437711;ITPC;57
2;3;439622;439710;ITPC;88
2;3;441783;441874;ITPC;91
2;3;443778;443868;ITPC;90
2;3;445525;445612;ITPC;87
2;3;447221;447314;ITPC;93
2;3;448618;448669;ITPC;51
2;3;448669;448712;ITPC;43
2;3;451219;451303;ITPC;84
2;3;454013;454098;ITPC;85
2;3;456689;456738;ITPC;49
2;3;456738;456773;ITPC;35
2;3;458450;458533;ITPC;83
2;3;460805;460846;ITPC;41
2;3;460846;460889;ITPC;43
2;3;462701;462788;ITPC;87
2;3;465436;465523;ITPC;87
2;3;467995;468045;ITPC;50
2;3;468045;468081;ITPC;36
2;3;470796;470881;ITPC;85
2;3;472494;472580;ITPC;86
2;3;474192;474278;ITPC;86
2;3;476408;476480;ITPC;72
2;3;476480;476495;ITPC;15
2;3;478882;478969;ITPC;87
2;3;481376;481463;ITPC;87
2;3;484073;484163;ITPC;90
2;3;485072;485161;ITPC;89
2;3;487968;488057;ITPC;89
2;3;490467;490556;ITPC;89
3;3;1115;1141;ITPC;26
3;3;3205;3264;ITPC;59
3;3;5096;5152;ITPC;56
3;3;7115;7133;ITPC;18
3;3;7133;7174;ITPC;41
3;3;7437;7469;ITPC;32
2;3;152940;152961;ITPC;21
2;3;153834;153884;ITPC;50
2;3;155678;155727;ITPC;49
2;3;157069;157127;ITPC;58
2;3;158401;158426;ITPC;25
2;3;160466;160483;ITPC;17
2;3;162074;162124;ITPC;50
2;3;164056;164076;ITPC;20
2;3;165975;166025;ITPC;50
2;3;168103;168130;ITPC;27
2;3;169797;169864;ITPC;67
2;3;171474;171508;ITPC;34
2;3;173332;173356;ITPC;24
2;3;173356;173381;ITPC;25
2;3;173381;173404;ITPC;23
2;3;175531;175601;ITPC;70
2;3;175601;175746;ITPC;99
2;3;176098;176189;ITPC;91
2;3;178500;178588;ITPC;88
2;3;181203;181232;ITPC;29
2;3;181232;181262;ITPC;30
2;3;181262;181292;ITPC;30
2;3;184001;184007;ITPC;6
2;3;184007;184059;ITPC;52
2;3;184059;184102;ITPC;43
2;3;186902;186912;ITPC;10
2;3;186912;186961;ITPC;49
2;3;186961;186989;ITPC;28
2;3;189908;189993;ITPC;85
2;3;192898;192938;ITPC;40
2;3;192938;192987;ITPC;49
